
  {
    "id": 2,
    "nombre": "mapa principal",
    "cancion": "priscila",
    "mapa": [
      [
        "##########",
        "#...#....#",
        "#...b.b..#",
        "###.######",
        "##...#..##",
        "##########",
        "###.....##",
        "#.#.M..###",
        "#.#.p...b#",
        "##########"
      ],
      [
        "##########",
        "#.._.....#",
        "#........#",
        "#.b..##..#",
        "#....##..p",
        "#....##..#",
        "#....M...#",
        "#........#",
        "#...##...#",
        "##########"
      ],
      [
        "##########",
        "#_....####",
        "##......=#",
        "#...######",
        "#....#####",
        "#....#####",
        "p...######",
        "#...b....#",
        "##..#....#",
        "##########"
      ]
    ]
  }