
{
  "id": 9,
  "nombre": "Monchi se reune con Yorman y son felices para siempre",
  "cancion": "Priscilla Snow - Multi Infinite.mp3",
  "mapa": [
    [
      "##########",
      "##########",
      "##########",
      "###_######",
      "##..######",
      "##Mp..####",
      "##_.b.####",
      "##=.######",
      "##########",
      "##########"
    ],[
      "##########",
      "##########",
      "#......###",
      "#......###",
      "#........p",
      "#......###",
      "#......###",
      "##########",
      "##########",
      "##########"
    ]
  ]
}