
{
  "id": 9,
  "nombre": "intro",
  "cancion": "priscila",
  "mapa": [
    [
      "##########",
      "#...#...=#",
      "#...b.b..#",
      "##......##",
      "##...#._##",
      "##......##",
      "###.....##",
      "###....###",
      "###.p...b#",
      "##########"
    ]
  ]
}