
  {
    "id": 0,
    "nombre": "Monchi empieza las clases",
    "cancion": "priscila",
    "mapa": [
      [
        "##########",
        "##########",
        "##=......#",
        "##.......#",
        "##.......#",
        "##......b#",
        "##.p...#.#",
        "##....##_#",
        "##########",
        "##########"
      ]
    ]
  }