
{
  "id": 2,
  "nombre": "Monchi hace amigos",
  "cancion": "Appendix",
  "mapa": [
    [
      "##########",
      "#_..#...=#",
      "#...b.b..#",
      "##......##",
      "##...#._##",
      "##......##",
      "###.....##",
      "###....###",
      "###.p..b_#",
      "##########"
    ]
  ]
}