
{
  "id": 1,
  "nombre": "intro",
  "cancion": "priscila",
  "mapa": [
    [
      "##########",
      "##########",
      "##...#####",
      "##.#b...##",
      "##.#b...##",
      "##..p...##",
      "##......##",
      "##......##",
      "##_..=._##",
      "##########"
    ]
  ]
}