
{
  "id": 4,
  "nombre": "intro",
  "cancion": "priscila",
  "mapa": [
    [
      "##########",
      "##########",
      "#.......##",
      "#...M..p##",
      "#...b...##",
      "#.......##",
      "#.########",
      "#.......=#",
      "#......._#",
      "##########"
    ],
    [
      "##########",
      "##########",
      "##.......#",
      "##.......#",
      "##.......p",
      "##.......#",
      "##.......#",
      "##.......#",
      "##########",
      "##########"
    ]
  ]
}