
{
  "id": 4,
  "nombre": "Monchi se enamora de Yorman",
  "cancion": "Cycle",
  "mapa": [
    [
      "##########",
      "##########",
      "#......###",
      "#.M..b.###",
      "#......###",
      "####.#####",
      "####.....#",
      "#....p..=#",
      "####...._#",
      "##########"
    ],
    [
      "##########",
      "##########",
      "##.......#",
      "##.......#",
      "##.......p",
      "##.......#",
      "##.......#",
      "##.......#",
      "##########",
      "##########"
    ]
  ]
}