
{
  "id": 6,
  "nombre": "intro",
  "cancion": "priscila",
  "mapa": [
    [
      "##########",
      "#..._....#",
      "#........#",
      "#...b.M..#",
      "#_...p.._#",
      "#...b.b..#",
      "#........#",
      "#........#",
      "#..._....#",
      "##########"
    ],
    [
      "##########",
      "##########",
      "##########",
      "##########",
      "######=..p",
      "##########",
      "##########",
      "##########",
      "##########",
      "##########"
    ]
  ]
}