
{
  "id": 7,
  "nombre": "intro",
  "cancion": "priscila",
  "mapa": [
    [
      "##########",
      "#.b.....##",
      "#.......##",
      "###.p.M.##",
      "###.....##",
      "###.....##",
      "###._.=.##",
      "###.....##",
      "###.....##",
      "##########"
    ],
    [
      "##########",
      "##########",
      "##########",
      "##########",
      "##########",
      "##########",
      "##########",
      "####_#####",
      "####b#####",
      "####p#####"
    ]
  ]
}