
{
  "id": 7,
  "nombre": "Monchi se pierde en las sendas del mal",
  "cancion": "Priscilla Snow - Empty.mp3",
  "mapa": [
    [
      "##########",
      "##########",
      "#........#",
      "#........#",
      "#..M.....#",
      "#_...._p.#",
      "#..M.....#",
      "#.......=#",
      "##########",
      "##########"
    ],
    [
      "##########",
      "######..##",
      "##.......#",
      "##.......#",
      "##.......p",
      "##.......#",
      "##.......#",
      "####.....#",
      "#######..#",
      "##########"
    ],
    [
      "##########",
      "##########",
      "##########",
      "##########",
      "##########",
      "##########",
      "##########",
      "####_#####",
      "####b#####",
      "####p#####"
    ]
  ]
}