
{
  "id": 0,
  "nombre": "intro",
  "cancion": "priscila",
  "mapa": [
    [
      "##########",
      "##########",
      "#........#",
      "#........#",
      "#........#",
      "#........#",
      "#........#",
      "#.......=#",
      "##########",
      "##########"
    ],
    [
      "##########",
      "#........#",
      "#........#",
      "#........#",
      "#........p",
      "#........#",
      "#........#",
      "#........#",
      "#........#",
      "##########"
    ],
    [
      "##########",
      "##########",
      "##########",
      "##########",
      "##########",
      "##########",
      "##########",
      "####_#####",
      "####b#####",
      "####p#####"
    ]
  ]
}