
{
  "id": 8,
  "nombre": "Monchi se encuentra a si mismo",
  "cancion": "InfinityExit",
  "mapa": [
    [
      "##########",
      "##########",
      "#=......##",
      "#.......##",
      "#.......##",
      "#_..p...M#",
      "#.......##",
      "#.......##",
      "##########",
      "##########"
    ],
    [
      "##########",
      ".........#",
      ".........#",
      ".........#",
      "p.......M#",
      ".........#",
      ".........#",
      ".........#",
      ".........#",
      "##########"
    ],
    [
      "##########",
      ".........#",
      ".......#.#",
      ".......#.#",
      "p......#M#",
      ".......#.#",
      ".......#.#",
      ".......#.#",
      ".........#",
      "##########"
    ],
    [
      "##########",
      "##########",
      "##.......#",
      "#..M.....#",
      "p........#",
      "####.....#",
      "##########",
      "##########",
      "##########",
      "##########"
    ],[
      "##########",
      "#......###",
      "#...b..###",
      "....#..###",
      "p...#..###",
      ".......###",
      ".......###",
      "##########",
      "##########",
      "##########"
    ]
  ]
}